xxxxxxxxxxxxxxxx
x              x
x   v      v   x
x              x
x              x
x      f       x
x              x
x              x
x              x
x   v      v   x
x              x
xxxxxxxxxxxxxxxx